10m.a
....mm....
....mmm...
....m....m
....m...m.
m......m.m
m...m.m.m.
...m....mm
..........
.m........
..........
